1111111111111111111111111111111111111111
1001000000000100000000000100000000000001
1001000000000100000000000100000000000001
1001111100100100111111100100111111111001
1000000100100100000000100100004340001001
1000000100100100000000100100000400001001
1111104100100111111100100111111111001001
1000043100100000000000100000000111001001
1000004100100000000000100000000111001001
1001111100111100111111100111100000001001
1001000000000100100000000100100000001001
1001000000000100100000000100100111111001
1001111111111100111100100100000000000001
1000000000000000100140100100000000000001
1000000000000000100134100111111111111001
1111111111111111100140100000000000001001
1000000000000000000100100000000000001111
1000000000000000000100111111111111000001
1111110011111111111100000100000001000001
1000010000000000000000000100000001111111
1000010000000000000000111111111000000001
1001111111001111111111110000000000000001
1001000431001000000000000000000001111001
1001000041001000000000000010011111111001
1001001001001111111111111110010000000001
1000001000000000100000000000010000000001
1000001000000000100000000000010011111111
1001111111111111111111111110010011111111
1000000000000000000000000000010434400000
1000000000000000000000000000010044340000
1111111111111111111111111111111111111111